R 700 700
NO ./textures/north.xpm
SO ./textures/south.xpm
EA ./textures/east.xpm

S ./textures/tree.xpm
C 41,70,117

WE ./textures/west.xpm
F 255,255,255
        1111111111111111111111111
        1W00000000110000000220001
        1011000001110000000220001
        1001000000000000000220001
111111111011000001110000000000001
100000000011000001110111111111111
11110111111111011100000010001
11110111111111011101010010001
11020020110121011100000010001
1000000000020000110000010001
1000002002000001101010010001
1102000111010101111101111010111
11110111 1110101 101111010001
11111111 1111111 111111111111

