R 700 700
NO ./textures/north.xpm
SO ./textures/south.xpm
EA ./textures/east.xpm

S ./textures/barrel.xpm
F 30,30,0

WE ./textures/west.xpm
C 100,50,10
        1111111111111111111111111
        1000000000110000000220001
        1011000001110000000220001
        1001000000000000000220001
111111111011000001110000000000001
100000000011000001110111111111111
11110111111111011100000010001
11110111111111011101010010001
11000000110101011100000010001
1000200000000000110000010001
1000000000000001101010010001
1100000111010101111101111010111
1111N111 1110101 101111010001
11111111 1111111 111111111111


