R 700 480
NO ./textures/north.xpm
SO ./textures/south.xpm
EA ./textures/east.xpm
WE ./textures/west.xpm

F 220,100,0
C 225,30,0
        1111111111111111111111111
        1W00000000110000000220001
        1011000001110000000220001
        1001000000000000000220001
111111111011000001110000000000001
100000000011000001110111111111111
11110111111111011100000010001
11110111111111011101010010001
11000000110101011100000010001
1000200000000000110000010001
1000000000000001101010010001
1100000111010101111101111010111
11110111 1110101 101111010001
11111111 1111111 111111111111


