R 1000 1000
NO ./textures/house.xpm
SO ./textures/house.xpm
EA ./textures/house.xpm

S ./textures/tree.xpm
F 0,200,100

WE ./textures/house.xpm
C 0,220,130

        1111111111111111111111111
        1000000020110002000220001
        1011000001112000000220001
        1001200000000000000220001
111111111011000001110000000000001
100000000011000001110111111111111
11110111111111011100000010001
11110111111111011101010210001
11020020110101011120000010001
1000002002000000110000210001
1020000000000201101010010001
1120002111010101111101111010111
1111N111 1110101 101111010001
11111111 1111111 111111111111


